MaxCombo=Højeste Combo
AvgTiming=Gns. Timing:
Score=Score
Accuracy=Præcision
DownloadMoreSongs=Hent flere sange...
ErrorWhileDownloadingSongListing=Fejl under hentning ad sanglisten.
HaveAllAvailableSongPacks=Du har alle tilgængelige pakker.\nKom tilbage senere!
Notice=Notifikation
Yes=Ja
No=Nej
Okay=Okay
Alert=Advarsel
HighScore=Højeste Score:
YouCantFail=Du kan ikke dø.
ExpertUnlock=Lås Ekspert op ved at få A rang eller højere i Stream mode!
Loading=Indlæser...
AndHoldUntilTheCircleExplodes=...og hold inde indtil cirklen eksploderer!
WelcomeToTheWorldOfOsu=Velkommen til osu! verdenen.\nDenne tutorial vil lære dig alt, hvad du skal vide for at blive en rythme mester.
TapToContinue=Tryk for at komme videre!
Introduction2=osu!stream er et spil, som kræver både rytmisk og stillingsmæssig præcision.
Introduction3=Du skal føle beatet, så husk at bruge hovedtelefoner, eller at spille i stille omgivelser!
Introduction4=Lad os starte med at kigge på de forskellige beats.
HitCircle1="Hitcircles" er det mest basale beat i osu!.
HitCircle2=De består af den primære cirkel...
HitCircle3=Og nærmecirklen.
HitCircle4=Når nærmecirklen når til kanten ad den primære cirkel...
HitCircle4_1=...skal du trykke!
HitCircle5=Jo mere præcis din timing er, des flere point får du!
Good=Godt...
Great=Mægtigt!
Perfect=Perfekt!
HitCircle6=Okay. Lad os prøve!\nPrøv at ramme disse 8 cirkler.
HitCircleJudge1=Hmm, det ser ud til at vi skal øve noget mere. Lad os prøve igen!
HitCircleJudge2=Næten!\nHold øje med den nærmende cirkel og lyt til rytmen. Lad os prøve igen!
